99,97,96,96,92,95,94,94,99,99,99,94
95,98,91,90,99,93,93,98,100,93,97,94
94,93,99,98,92,92,99,93,93,98,99,98
96,96,96,96,97,97,96,100,100,100,92,99
96,97,92,98,92,96,90,99,91,90,93,97
90,97,95,99,100,90,100,91,97,99,91,99
99,96,99,98,98,100,97,98,92,98,92,99
99,94,97,97,95,92,92,98,95,98,96,92